time taken: 1.0s; total stages: 2149; done stage: 2000; stages left: 148; moves: S,L1,L1,L1,D0,L0,L2,U1,L0,U2,U4,U4,L4,R3,U3; added 1 stages: 2148:S,L1,L1,L1,D0,L0,L2,U1,L0,U2,U4,U4,L4,R3,U3,U3
PUZZLE COMPLETE !!!
seq: [0], moves: S
XX XX XX XX XX XX XX XX
XX XX XX XX .. .. .. XX
XX oo oo XX B0 XX .. XX
XX             B1 .. XX
XX oo B2       XX .. XX
XX oo oo B3 B4 XX .. XX
XX XX XX XX .. .. .. XX
XX XX XX XX XX XX XX XX
seq: [0, 2], moves: S,L1
XX XX XX XX XX XX XX XX
XX XX XX XX .. .. .. XX
XX oo oo XX B0 XX .. XX
XX          B1 .. .. XX
XX oo B2       XX .. XX
XX oo oo B3 B4 XX .. XX
XX XX XX XX .. .. .. XX
XX XX XX XX XX XX XX XX
seq: [0, 2, 6], moves: S,L1,L1
XX XX XX XX XX XX XX XX
XX XX XX XX .. .. .. XX
XX oo oo XX B0 XX .. XX
XX       B1 .. .. .. XX
XX oo B2 .. .. XX .. XX
XX oo oo B3 B4 XX .. XX
XX XX XX XX .. .. .. XX
XX XX XX XX XX XX XX XX
seq: [0, 2, 6, 17], moves: S,L1,L1,L1
XX XX XX XX XX XX XX XX
XX XX XX XX .. .. .. XX
XX oo oo XX B0 XX .. XX
XX    B1 .. .. .. .. XX
XX oo B2 .. .. XX .. XX
XX oo oo B3 B4 XX .. XX
XX XX XX XX .. .. .. XX
XX XX XX XX XX XX XX XX
seq: [0, 2, 6, 17, 47], moves: S,L1,L1,L1,L1
XX XX XX XX XX XX XX XX
XX XX XX XX .. .. .. XX
XX oo oo XX B0 XX .. XX
XX B1 .. .. .. .. .. XX
XX oo B2 .. .. XX .. XX
XX oo oo B3 B4 XX .. XX
XX XX XX XX .. .. .. XX
XX XX XX XX XX XX XX XX
seq: [0, 2, 6, 17, 47, 110], moves: S,L1,L1,L1,L1,D1
XX XX XX XX XX XX XX XX
XX XX XX XX .. .. .. XX
XX oo oo XX B0 XX .. XX
XX .. .. .. .. .. .. XX
XX B1 B2 .. .. XX .. XX
XX oo oo B3 B4 XX .. XX
XX XX XX XX .. .. .. XX
XX XX XX XX XX XX XX XX
seq: [0, 2, 6, 17, 47, 110, 204], moves: S,L1,L1,L1,L1,D1,D1
XX XX XX XX XX XX XX XX
XX XX XX XX .. .. .. XX
XX oo oo XX B0 XX .. XX
XX .. .. .. .. .. .. XX
XX oo B2 .. .. XX .. XX
XX B1 oo B3 B4 XX .. XX
XX XX XX XX .. .. .. XX
XX XX XX XX XX XX XX XX
seq: [0, 2, 6, 17, 47, 110, 204, 318], moves: S,L1,L1,L1,L1,D1,D1,R2
XX XX XX XX XX XX XX XX
XX XX XX XX .. .. .. XX
XX oo oo XX B0 XX .. XX
XX .. .. .. .. .. .. XX
XX oo .. B2 .. XX .. XX
XX B1 oo B3 B4 XX .. XX
XX XX XX XX .. .. .. XX
XX XX XX XX XX XX XX XX
seq: [0, 2, 6, 17, 47, 110, 204, 318, 464], moves: S,L1,L1,L1,L1,D1,D1,R2,D0
XX XX XX XX XX XX XX XX
XX XX XX XX .. .. .. XX
XX oo oo XX .. XX .. XX
XX          B0 .. .. XX
XX oo    B2    XX .. XX
XX B1 oo B3 B4 XX .. XX
XX XX XX XX .. .. .. XX
XX XX XX XX XX XX XX XX
seq: [0, 2, 6, 17, 47, 110, 204, 318, 464, 666], moves: S,L1,L1,L1,L1,D1,D1,R2,D0,L0
XX XX XX XX XX XX XX XX
XX XX XX XX .. .. .. XX
XX oo oo XX .. XX .. XX
XX       B0 .. .. .. XX
XX oo    B2 .. XX .. XX
XX B1 oo B3 B4 XX .. XX
XX XX XX XX .. .. .. XX
XX XX XX XX XX XX XX XX
seq: [0, 2, 6, 17, 47, 110, 204, 318, 464, 666, 935], moves: S,L1,L1,L1,L1,D1,D1,R2,D0,L0,L0
XX XX XX XX XX XX XX XX
XX XX XX XX .. .. .. XX
XX oo oo XX .. XX .. XX
XX    B0 .. .. .. .. XX
XX oo    B2 .. XX .. XX
XX B1 oo B3 B4 XX .. XX
XX XX XX XX .. .. .. XX
XX XX XX XX XX XX XX XX
seq: [0, 2, 6, 17, 47, 110, 204, 318, 464, 666, 935, 1258], moves: S,L1,L1,L1,L1,D1,D1,R2,D0,L0,L0,L0
XX XX XX XX XX XX XX XX
XX XX XX XX .. .. .. XX
XX oo oo XX .. XX .. XX
XX B0 .. .. .. .. .. XX
XX oo .. B2 .. XX .. XX
XX B1 oo B3 B4 XX .. XX
XX XX XX XX .. .. .. XX
XX XX XX XX XX XX XX XX
seq: [0, 2, 6, 17, 47, 110, 204, 318, 464, 666, 935, 1258, 1579], moves: S,L1,L1,L1,L1,D1,D1,R2,D0,L0,L0,L0,U0
XX XX XX XX XX XX XX XX
XX XX XX XX .. .. .. XX
XX B0 oo XX .. XX .. XX
XX .. .. .. .. .. .. XX
XX oo .. B2 .. XX .. XX
XX B1 oo B3 B4 XX .. XX
XX XX XX XX .. .. .. XX
XX XX XX XX XX XX XX XX
seq: [0, 2, 6, 17, 47, 110, 204, 318, 464, 666, 935, 1258, 1579, 1850], moves: S,L1,L1,L1,L1,D1,D1,R2,D0,L0,L0,L0,U0,L2
XX XX XX XX XX XX XX XX
XX XX XX XX .. .. .. XX
XX B0 oo XX .. XX .. XX
XX .. .. .. .. .. .. XX
XX oo B2 .. .. XX .. XX
XX B1 oo B3 B4 XX .. XX
XX XX XX XX .. .. .. XX
XX XX XX XX XX XX XX XX
seq: [0, 2, 6, 17, 47, 110, 204, 318, 464, 666, 935, 1258, 1579, 1850, 2046], moves: S,L1,L1,L1,L1,D1,D1,R2,D0,L0,L0,L0,U0,L2,L2
XX XX XX XX XX XX XX XX
XX XX XX XX .. .. .. XX
XX B0 oo XX .. XX .. XX
XX .. .. .. .. .. .. XX
XX B2 .. .. .. XX .. XX
XX B1 oo B3 B4 XX .. XX
XX XX XX XX .. .. .. XX
XX XX XX XX XX XX XX XX
seq: [0, 2, 6, 17, 47, 110, 204, 318, 464, 666, 935, 1258, 1579, 1850, 2046, 2175], moves: S,L1,L1,L1,L1,D1,D1,R2,D0,L0,L0,L0,U0,L2,L2,U4
XX XX XX XX XX XX XX XX
XX XX XX XX .. .. .. XX
XX B0 oo XX .. XX .. XX
XX .. .. .. .. .. .. XX
XX B2 .. .. B4 XX .. XX
XX B1 oo B3 .. XX .. XX
XX XX XX XX .. .. .. XX
XX XX XX XX XX XX XX XX
seq: [0, 2, 6, 17, 47, 110, 204, 318, 464, 666, 935, 1258, 1579, 1850, 2046, 2175, 2262], moves: S,L1,L1,L1,L1,D1,D1,R2,D0,L0,L0,L0,U0,L2,L2,U4,L3
XX XX XX XX XX XX XX XX
XX XX XX XX .. .. .. XX
XX B0 oo XX .. XX .. XX
XX .. .. .. .. .. .. XX
XX B2 .. .. B4 XX .. XX
XX B1 B3 .. .. XX .. XX
XX XX XX XX .. .. .. XX
XX XX XX XX XX XX XX XX
seq: [0, 2, 6, 17, 47, 110, 204, 318, 464, 666, 935, 1258, 1579, 1850, 2046, 2175, 2262, 2319], moves: S,L1,L1,L1,L1,D1,D1,R2,D0,L0,L0,L0,U0,L2,L2,U4,L3,U4
XX XX XX XX XX XX XX XX
XX XX XX XX .. .. .. XX
XX B0 oo XX .. XX .. XX
XX .. .. .. B4 .. .. XX
XX B2 .. .. .. XX .. XX
XX B1 B3 .. .. XX .. XX
XX XX XX XX .. .. .. XX
XX XX XX XX XX XX XX XX
seq: [0, 2, 6, 17, 47, 110, 204, 318, 464, 666, 935, 1258, 1579, 1850, 2046, 2175, 2262, 2319, 2347], moves: S,L1,L1,L1,L1,D1,D1,R2,D0,L0,L0,L0,U0,L2,L2,U4,L3,U4,L4
XX XX XX XX XX XX XX XX
XX XX XX XX .. .. .. XX
XX B0 oo XX .. XX .. XX
XX .. .. B4 .. .. .. XX
XX B2 .. .. .. XX .. XX
XX B1 B3 .. .. XX .. XX
XX XX XX XX .. .. .. XX
XX XX XX XX XX XX XX XX
seq: [0, 2, 6, 17, 47, 110, 204, 318, 464, 666, 935, 1258, 1579, 1850, 2046, 2175, 2262, 2319, 2347, 2361], moves: S,L1,L1,L1,L1,D1,D1,R2,D0,L0,L0,L0,U0,L2,L2,U4,L3,U4,L4,L4
XX XX XX XX XX XX XX XX
XX XX XX XX .. .. .. XX
XX B0 oo XX .. XX .. XX
XX    B4 .. .. .. .. XX
XX B2 .. .. .. XX .. XX
XX B1 B3 .. .. XX .. XX
XX XX XX XX .. .. .. XX
XX XX XX XX XX XX XX XX
seq: [0, 2, 6, 17, 47, 110, 204, 318, 464, 666, 935, 1258, 1579, 1850, 2046, 2175, 2262, 2319, 2347, 2361, 2365], moves: S,L1,L1,L1,L1,D1,D1,R2,D0,L0,L0,L0,U0,L2,L2,U4,L3,U4,L4,L4,U4
XX XX XX XX XX XX XX XX
XX XX XX XX .. .. .. XX
XX B0 B4 XX .. XX .. XX
XX .. .. .. .. .. .. XX
XX B2 .. .. .. XX .. XX
XX B1 B3 .. .. XX .. XX
XX XX XX XX .. .. .. XX
XX XX XX XX XX XX XX XX
total puzzle solve time: 2.0s

Process finished with exit code 0
